8 8 9
####################################################################################################
#..................................................................................................#
#......######....#.................................................................................#
#.....#&.&.&.&&.#..................................................................................#
#.....#&&.&.&..#.......QQQQQQQQ....................................................................#
#......########........####### ....................................................................#
#............................. ....................................................................#
#............................. ....................................................................#
#............................. ....................................................................#
#............................. ....................................................................#
#............................. ....................................................................#
#............................. ....................................................................#
#............................. ....................................................................#
#............................. ....................................................................#
#..................................................................................................#
#..................................................................................................#
#..................................................................................................#
#..................................................................................................#
#..................................................................................................#
#..................................................................................................#
#..................................................................................................#
#..................................................................................................#
#..................................................................................................#
#..................................................................................................#
#..................................................................................................#
#..................................................................................................#
#..................................................................................................#
#..................................................................................................#
#..................................................................................................#
#..................................................................................................#
#..................................................................................................#
#..................................................................................................#
#..................................................................................................#
#..................................................................................................#
#..................................................................................................#
#..................................................................................................#
#..................................................................................................#
#..................................................................................................#
#..................................................................................................#
#..................................................................................................#
#..................................................................................................#
#..................................................................................................#
#..................................................................................................#
#..................................................................................................#
#..................................................................................................#
#..................................................................................................#
#..................................................................................................#
#..................................................................................................#
####################################################################################################